---------------
-1++++++++++++-
-+++++++++++++-
-+++++++++++++-
-+++++++++++++-
-+++++++++++++-
-+++++++++++++-
-+++++++++++++-
-+++++++++++++-
-+++++++++++++-
-+++++++++++++-
-+++++++++++++-
-++++++2++++++-
-+++++++++++++-
---------------