---------------
-1+++++t++++tp-
-+-------------
-+++++mmm+++++-
-----++++----+-
-++++++t++++++-
-+-------------
-+++++++++++++-
-------m-----+-
-+++++++m+++++-
-+-------------
-++++++m++++++-
-------------+-
-p+++++++++++k-
---------------