---------------
-1+++++t++++tp-
-+-------------
-+++++mmm+++++-
-----++++----+-
-++++++t++++++-
-+-------------
-++2++++++++++-
-------m-----+-
-+++++++m+++++-
-+-------------
-++++++m++++++-
-------------+-
-p+++++++2+++k-
---------------