----------------
-++++---+++-++1-
-+2++++++++++tt-
-+---++++++++++-
-+++----p----++-
-++++++---+++++-
-++++++++++2+++-
-2--+++++--++++-
-++-------+++++-
-+++++++++++--+-
-++++2++++---++-
-+++++-----++++-
-+2+---++++++++-
-k+t++++---m++p-
----------------