---------------
-2++-+++-++++1-
-+-+-+-+-+-----
-+-+-+-+-+++++-
-+-+-+-+-----+-
-+-+-+-+-+++++-
-+-m-+-m-+-----
-+-+-+-+-++2++-
-+-+-+-+-----+-
-+-+-+-+-+++++-
-+-+-+-+-+-----
-+-+-+-+-+++++-
-+-+-+-+-++t++-
-k-+++-++2++++-
---------------