---------------
-+++-+++-++++1-
-+-+-+-+-+-----
-+-+-+-+-+++++-
-+-+-+-+-----+-
-+-+-+-+-+++++-
-+-m-+-m-+-----
-+-+-+-+-+++++-
-+-2-+-+-----+-
-+-+-+-+-+++++-
-+-+-+-+-+-----
-+-+-+-+-+++++-
-+-+-+-+-----+-
-k-+++-+2+++++-
---------------