----------------
-p+2++---+++-+1-
-+++-+++-+-+++t-
--++---+++--+++-
---+-++m+++++++-
-+++++++++++2++-
--+++++++t+++++-
-++++t+2+++++++-
-++++++++-++-++-
-++++t+++++--mp-
-++---++++++----
-+m++-+---++++t-
----+++-m++++-+-
-+++2+++++++++k-
----------------