---------------
-1+++++b+++++p-
-+---++++++----
-+++++b+++++++-
-----++++b+--2-
-+++++++++++++-
-+---2---------
-++2+++b++++++-
-------b-----+-
-+++++++b+++++-
-+-------------
-++++++b++++++-
-------------+-
-p+++++++2+++k-
---------------