-----------+----
-1>gb<x~--------
---------+-+-+--
--+-++----------
-----------+----
--++++++-+-++++-
-++------+------
--+-+++++++++++-
--+------+------
--++++++-+-++++-
----------------