-----------+---p
-+>gb<x~--------
---------+-+-+--
-p+-++----------
-----------+----
--++++++-+-++++-
-++------+------
--+-+++++++++++-
--+------+------
--++++++-+-++++-
----------------